22
*
14
*
1
*
00-1-0
#
01-1-1
#
02-1-2
#
03-1-3
#
04-1-4
#
05-1-5
#
06-1-6
#
07-1-7
#
08-1-8
#
09-1-9
*
0000000000000000000011
0000000000000000000011
0000000000000000000011
0000000000000000000000
0000000000000000000000
0000000000000000111111
0000000000000001111111
0000000000000011111111
0000000000000111111111
0000000000001111111111
1111111111111111111111
1111111111111111111111
*
04 04 04 04 04 04 04 04 04 04 04 04 04 04 04 04 04 04 04 04 06 02
04 04 04 04 04 04 04 04 04 04 04 04 04 04 04 04 04 04 04 04 06 02
04 04 04 04 04 04 04 04 04 04 04 04 04 04 04 04 04 04 04 04 06 02
04 04 04 04 04 04 04 04 04 04 04 04 04 04 04 04 04 04 04 04 04 05
04 04 04 04 04 04 04 04 04 04 04 04 04 04 04 04 04 04 04 04 04 05
04 04 04 04 04 04 04 04 04 04 04 04 04 04 04 04 09 00 00 00 00 00
04 04 04 04 04 04 04 04 04 04 04 04 04 04 04 09 02 02 02 02 02 02
04 04 04 04 04 04 04 04 04 04 04 04 04 04 09 02 02 02 02 02 02 02
04 04 04 04 04 04 04 04 04 04 04 04 04 09 02 02 02 02 02 02 02 02
01 01 01 01 01 01 01 01 01 01 01 01 09 02 02 02 02 02 02 02 02 02
00 00 00 00 00 00 00 00 00 00 00 00 02 02 02 02 02 02 02 02 02 02
02 02 02 02 02 02 02 02 02 02 02 02 02 02 02 02 02 02 02 02 02 02
*
0-8
*
21-4-mapa2