20
*
20
*
1
*
00-1-0
#
01-1-1
#
02-1-2
#
03-1-3
#
04-1-4
#
05-1-5
#
06-1-6
#
07-1-7
#
08-1-8
#
09-1-9
#
10-1-10
#
11-1-11
#
12-1-12
#
13-1-13
#
14-1-14
#
15-1-15
#
16-1-16
#
17-1-17
#
18-1-18
#
19-1-19
#
20-1-20
#
21-1-21
#
22-1-22
#
23-1-23
#
24-1-24
*
13,13,13,13,3,13,3,3,3,3,3,3,3,3,13,3,13,13,13,13,
13,13,13,13,3,13,3,3,3,3,3,3,3,3,13,3,13,13,13,13,
13,13,13,13,3,13,3,3,3,3,3,3,3,3,13,3,13,13,13,13,
13,13,13,13,3,13,3,3,3,3,3,3,3,3,13,3,13,13,13,13,
13,13,13,13,3,13,3,3,3,3,3,3,3,3,13,3,13,13,13,13,
13,13,13,3,3,3,3,3,3,3,3,3,3,3,3,3,3,13,13,13,
13,13,3,3,3,3,3,3,3,3,3,3,3,3,3,3,3,3,13,13,
13,3,3,3,3,3,3,3,3,3,3,3,3,3,3,3,3,3,3,13,
3,3,3,3,3,3,3,3,3,3,3,3,3,3,3,3,3,3,3,3,
14,13,13,13,14,13,13,13,14,13,13,13,14,13,13,13,14,13,13,14,
14,13,13,13,14,13,13,13,14,13,13,13,14,13,13,13,14,13,13,14,
3,3,3,3,3,3,3,3,3,3,3,3,3,3,3,3,3,3,3,3,
13,3,3,3,3,3,3,3,3,3,3,3,3,3,3,3,3,3,3,13,
13,13,3,3,3,3,3,3,3,3,3,3,3,3,3,3,3,3,13,13,
13,13,13,3,3,3,3,3,3,3,3,3,3,3,3,3,3,13,13,13,
13,13,13,13,3,13,3,3,3,3,3,3,3,3,13,3,13,13,13,13,
13,13,13,13,3,13,3,3,3,3,3,3,3,3,13,3,13,13,13,13,
13,13,13,13,3,13,3,3,3,3,3,3,3,3,13,3,13,13,13,13,
13,13,13,13,3,13,3,3,3,3,3,3,3,3,13,3,13,13,13,13,
13,13,13,13,3,13,3,3,3,3,3,3,3,3,13,3,13,13,13,13
*
0,0,0,0,0,0,0,0,0,0,0,0,0,0,0,0,0,0,0,0,
0,0,0,0,0,0,0,0,0,0,0,0,0,0,0,0,0,0,0,0,
0,0,0,0,0,0,0,0,0,0,0,0,0,0,0,0,0,0,0,0,
0,0,0,0,0,0,0,0,0,0,0,0,0,0,0,0,0,0,0,0,
0,0,0,0,0,0,0,0,0,0,0,0,0,0,0,0,0,0,0,0,
0,0,0,0,0,0,0,0,0,0,0,0,0,0,0,0,0,0,0,0,
0,0,0,0,0,0,0,0,0,0,0,0,0,0,0,0,0,0,0,0,
0,0,0,0,0,0,0,0,0,0,0,0,0,0,3,2,0,0,0,0,
1,1,1,1,1,1,1,1,1,1,1,1,1,1,1,1,1,1,1,1,
0,0,0,0,0,0,0,0,0,0,0,0,0,0,0,0,0,0,0,0,
0,0,0,0,0,0,0,0,0,0,0,0,0,0,0,0,0,0,0,0,
1,1,1,1,1,1,1,1,1,1,1,1,1,1,1,1,1,1,1,1,
0,0,0,0,0,0,0,0,0,0,0,0,0,0,0,0,0,0,0,0,
0,0,0,0,0,0,0,0,0,0,0,0,0,0,0,0,0,0,0,0,
0,0,0,0,0,0,0,0,0,0,0,0,0,0,0,0,0,0,0,0,
0,0,0,0,0,0,0,0,0,0,0,0,0,0,0,0,0,0,0,0,
0,0,0,0,0,0,0,0,0,0,0,0,0,0,0,0,0,0,0,0,
0,0,0,0,0,0,0,0,0,0,0,0,0,0,0,0,0,0,0,0,
0,0,0,0,0,0,0,0,0,0,0,0,0,0,0,0,0,0,0,0,
0,0,0,0,0,0,0,0,0,0,0,0,0,0,0,0,0,0,0,0
*
4-4
*
4-4-mapa2